5 10 20
SSSSBWWWWW
WBSSSWBSSW
BSSWWWSSSW
SSBSSSSSSB
SSSSSWWWBS

5 10 20
SSSSBSSSSS
WBSSSWBSSS
BSSWSSSSSW
SSBSSSBSSB
SSSSSWWWBS

5 10 20
SWSBSSSSSW
SSSSWWSSSS
SBBSSSSSSS
WSSSSSBSWS
WSSSBWSSSS


5 10 20
SSSSSSSSSSS
SSSSSSSSSSS
SSSSSSSSSSS
SSSSSSSSSSS
SSSSSSSSSSS
SSSSSSSSSSS