5 10 20
SSSSBWWWWW
WBSSSWBSSW
BSSWWWSSSW
SSBSSSSSSB
SSSSSWWWBS